NO /textures/n.xpm
SO /textures/s.xpm
WE /textures/w.xpm
EA /textures/e.xpm

F 155,255,255

C	  25          5 ,255,255

1111111111111111111111
1000000100000000000001
10W0000000000000000001
1111111110000000000111
1000000001000000100001
100000000000000100001
1111111111111111111111