NO /textures/n.xpm


F 150,150,200

            SO /textures/s.xpm

    WE /textures/w.xpm
EA /textures/e.xpm


C 150,150,10






111111111
100000001
101010101
101010101
101010101
101010101
101010101
101010101
101010001
101010101
101010101
101010101
101010101
1E1000101
101111101
100000001
111111111
