NO /textures/n.xpm



            SO /textures/s.xpm

C 135, 206, 235
    WE /textures/w.xpm



EA /textures/e.xpm

F 139,105,20






11111111111111111111111111111
1N000000000000000000000010001
11111111111111111000100100001
11110000000000000011100100001
    111111111111110000000000011111111111111111
    111111111111111111111100000000000000000001
    111111111111111111110000000000000000000011
    111111111111111111110111111110000000000111
    111111111111111111110111111100100000110011
    11111111111111111111011111111111111111111
11111111111111111110100000001
10000000011000000010101100001
10000000100000000001101000001
10001000000111111110001000001
10001110000000000100000010001
11111111111111111111111111101
11110000000000000000000000001            
    111111111111110000000000011111111111111111
    111111111111111111111111000000000000000001
    111111111111111111110000000000000000000011
    111111111111111111111111111110000000000111
    111111111111111111111111111100100000110011
    111111111111111111111111111111111111111111
