NO /textures/Test_NO.xpm
SO /textures/Test_SO.xpm
WE /textures/Test_WE.xpm
EA /textures/Test_ES.xpm

C 51,255,255
F 153,76,0

1111111111111
1000000000001
10000S0000001
1000010000001
1111111111111
