NO ./textures/materias/wood1.xpm


F 25,25,25

            SO ./textures/materias/wall_rock.xpm

    WE ./textures/materias/wall_rock2.xpm
EA ./textures/materias/wood2.xpm


C 200,200,200






11111111111111111111111
10000000000000000000001
10000000000000000000001
10000000000000000000001
11111111111100000100001
11111111111100000000001
11111111111100000000001
11111111111100000000001
11111111111100000000001
11111111111100000000001
111111111111000000N0001
11111111111111111111111
