NO ./textures/wall1.xpm
SO ./textures/wall2.xpm
                            F -55,255,255
WE ./textures/wall3.xpm
EA ./textures/wall5.xpm
C 35           ,264,25

1111111111111111111111
1000000100000000000001
1000000100000000000001
1000001000000S00000001
1000000001000000100001
1000000000000000100001
1111111111111111111111
