NO ./textures/wall1.xpm
SO ./textures/wall2.xpm
F 155,255,255
WE ./textures/wall3.xpm
EA ./textures/wall5.xpm
C  25     	        5 ,255,255

1111111111111111111111
1000000100000000000001
1000000100000000000001
100000100000000S000001
1000000001000000100001
100000000000000100001
1111111111111111111111


