NO /textures/Test_NO.xpm
SO /textures/Test_SO.xpm
WE /textures/Test_WE.xpm


F 155,255,255

C	  25          5 ,255,2566666

1111111111111111111111
1000000100000000000001
10N0000000000000000001
1111111110000000000111
1000000001000000100001
100000000000000100001
1111111111111111111111