NO ./textures/wall1.xpm
SO ./textures/wall2.xpm
F 125,200,10
WE ./textures/wall3.xpm
EA ./textures/wall5.xpm
C 135,206,235


1111111111111111111111
1000000100000000000001
1000000100000000000001
100000100000000E00001
1000000001000000100001
1000000000000000100001
1111111111111111111111
