NO ./textures/magic_cub/yellow.xpm



      SO ./textures/magic_cub/blue.xpm
WE ./textures/magic_cub/green.xpm
EA ./textures/magic_cub/red.xpm

C 255,255,255
F 255,255,255






111111111111111111111111111111111111111
10010S0 001011111111110000000000 
10000111000000001100000000111111
11111111111110000000000111111
             1111111111111111111
                     10000000001
                     1000000001
                     11111111111
