NO ./textures/magic_cub/yellow.xpm



      SO ./textures/magic_cub/blue.xpm
WE ./textures/magic_cub/green.xpm
EA ./textures/magic_cub/red.xpm

C 255,255,255
F 255,255,255






11111111111111
10010001000101111111111           11111
10000100010000000000001           10001
111111111111100000000001          11111
                 111111111111111
                     10000000001
                     10000000N01
                     11111111111