NO ./textures/magic_cub/yellow.xpm



      SO ./textures/magic_cub/blue.xpm
WE ./textures/magic_cub/green.xpm
EA ./textures/magic_cub/red.xpm

C 200,200,200
F 255,165,0



1111111111111111111111111111111
1000000000000000000100000000001
1000000000000000000000000000001
11111111111111100000000000000001
              100000000000000001
              100000000000000001
             1000000000000E00001
             1111111111111111111
