NO textures/amauri.xpm


F 150,150,200

            SO textures/amauri.xpm

    WE textures/amauri.xpm
EA textures/amauri.xpm


C 150,150,200






111111111
100000001
101010101
101010101
101010101
101010101
101010101
101010101
10  10001
101010101
101010101
101010101
101010101
1N1000101
101111101
100000001
111111111
