
NO /qualquercoisaainafrente.xpm
SO /xxx.xpm
WE /xxx.xpm
EA /xxx.xpm

F 254,254,254
C 212,212,212

11111
10001
10001
10S01
10001
11111