NO /textures/n.xpm


SO /textures/s.xpm
WE /textures/w.xpm
EA /textures/e.xpm

C 11, 26, 215
F 2a55, 128, 64






111111111111111111111111111111111111111
10010S01001011111111110000000000 
10000111000000001100000000111111
11111111111110000000000111111
             1111111111111111111
                     10000000001
                     1000000001
                     11111111111
